#  #  #  #  #  #  #  #  #  #  #  #  #  #  #  #  #  #  #  #  #  #     #  #  #  #  #  A  #
                                 #  #  #  #  #  #  #  #  #  #  #     #  #  #  #  #     #
#  #  #     #  #  #  #  #  #                                   #                 #     #
#  #  #     #              #  #     #  #     #  #  #  #  #     #     #  #  #     #     #
#  #  #     #     #  #     #  #     #  #     #  #  #  #  #     #     #  #  #     #     #
#  #  #           #  #  #  #  #     #                 #  #  #  #     #  #  #  #  #     #
#  #  #  #  #     #  #     #  #     #  #  #  #  #     #  #  #  #              #        #
#  #  #  #  #     #                    #  #  #  #                    #  #     #     #  #
#  #              #     #  #  #  #                 #  #  #  #  #  #  #  #  #  #     #   
#  #     #  #  #  #              #     #  #  #  #  #  #  #  #  #  #  #  #     #         
#  #     #  #  #  #  #     #     #     #  #                                   #     #   
#  #                       #           #  #     #  #  #  #  #  #  #  #     #  #     #  #
#  #     #  #  #  #  #  #  #  #  #  #  #  #     #  #  #  #  #  #  #  #     #  #        #
#  #     #  #           #  #  #     #  #  #     #                          #  #  #     #
#  #     #  #     #     #  #  #     #  #  #     #     #  #  #  #  #  #     #  #        #
#  #     #  #     #                             #     #  #                 #  #     #  #
#  #     #  #     #  #  #  #     #  #  #  #  #  #     #  #     #  #  #  #  #  #     #   
#  #     #  #     #  #  #  #     #  #  #  #  #  #     #  #     #  #  #  #  #  #         
#  #     #  #                                   #     #  #     #                    #  #
#  #     #  #  #  #  #  #  #     #  #  #  #  #  #  #  #  #     #  #  #  #  #  #         
#  #                 #  #  #     #  #  #  #     #  #           #  #  #  #  #  #     #  #
#  #  #  #  #  #                                #        #                          #  #
#  #  #  #  #  #  #  #  #  #     #  #  #  #     #     #  #  #  #  #  #  #  #  #  #  #  #
#  #  #  #  #  #  #  #  #  #  #  #  #  #  #     #                       #  #  #  #  #  #
#  #                          #  #  #  #  #     #     #  #  #  #     #  #  #  #  #      
#  #     #  #     #  #  #     #  #  #  #  #     #     #  #  #  #                 #     #
#  #     #  #     #  #  #                          #     #  #  #     #  #     #  #     #
#        #  #     #  #  #  #  #  #  #  #  #  #  #  #     #           #  #              #
#  #  #  #  #     #  #  #  #  #  #  #  #  #  #  #  #     #  #  #     #  #     #     #  #
B                 #  #  #  #  #  #  #  #  #  #  #  #        #  #  #  #  #  #  #     #  #